.#...#.....#..#.
...#.###.###....
.#.....!......#.
.###..#..#..###.
.....##..##.....
.#............#.
.#.###.##.###.#.
.......##.......
.#.###.##.###.#.
.....#....#.....
.###.##..##.###.
.#.....@......#.
...#.###.###....
.#...#.....#..#.
----------------
----------------