.#...#.....#..##
.#.#..##.##...!#
.#..............
...#.....##.....
####.....###.##.
......#......##.
..##....#.......
.......#....##..
.##......#......
.##.###.....####
.....##.....#...
..............#.
#@...##.##..#.#.
##..#.....#...#.
----------------
----------------