................
..@.............
................
................
............!...
................
................
................
................
................
................
................
................
................
----------------