.......!........
..#..........#..
..####....####..
..###..##..###..
..#....##....#..
..###......###..
......####......
##............##
.......##.......
....#...@..#....
....#..##..#....
#####......#####
................
................
----------------
----------------